+--+--+--+--+
|           |
|           |
+  +--+  +  +
|  |     |  |
+  +  +--+--+
|  |  |
|  |  +-----+
|  |       |
|  |        |
+  +--+--+  +
|        | g |
+--+--+--+---+
