+--+--+--+--+--+--+
|         |      g|
|         |       |
+  +--+   +-+--+  +
|  |        |     |
|  |        |     |
+  +  +--+--+  +  +
|        |        |
|                 |
+--+--+--+--+--+--+