+--+--+--+--+--+
|      |      g|
|      |       |
+  +---+---+   +
|      |       |
|      |       |
+--+   +  +--+ +
|              |
|              |
|              |
+--+--+--+--+--+
