+--+--+--+--+--+
|   |         g|
|   |          |
+   + -+--+  + +
|      |       |
|      |       |
+--+   +--+  + +
|              |
|              |
+--+--+--+--+--+